Rk;90s;Tkl;TklW;Def 3rd;Mid 3rd;Att 3rd;Tkl;Att;Tkl%;Lost;Blocks;Sh;Pass;Int;Tkl+Int;Clr;Err
1;20.9;49;25;32;15;2;28;52;53.8;24;25;10;15;25;74;57;0
2;6.5;19;11;8;11;0;4;16;25.0;12;6;2;4;10;29;2;0
3;10.0;6;4;2;4;0;4;7;57.1;3;12;8;4;8;14;36;1
4;33.0;0;0;0;0;0;0;0;;0;0;0;0;1;1;13;2
5;11.2;34;19;9;23;2;17;35;48.6;18;13;4;9;17;51;17;0
6;9.0;0;0;0;0;0;0;0;;0;1;0;1;0;0;8;3
7;2.4;8;6;6;2;0;3;4;75.0;1;1;1;0;1;9;11;1
8;7.9;21;14;8;12;1;9;15;60.0;6;9;7;2;4;25;19;0
9;0.5;1;1;1;0;0;1;2;50.0;1;1;1;0;0;1;0;0
10;11.5;12;5;8;3;1;9;17;52.9;8;8;6;2;14;26;42;2
11;12.7;16;12;5;7;4;6;18;33.3;12;7;0;7;7;23;12;0
12;15.6;43;28;27;16;0;26;41;63.4;15;13;1;12;36;79;38;0
13;15.8;27;17;17;10;0;11;22;50.0;11;16;6;10;39;66;56;0
14;22.3;12;9;2;8;2;3;8;37.5;5;8;1;7;3;15;17;0
15;4.6;9;5;4;3;2;2;13;15.4;11;4;0;4;5;14;5;0
16;8.6;6;3;1;4;1;0;2;0.0;2;8;1;7;2;8;4;0
17;1.4;3;2;0;3;0;2;3;66.7;1;1;0;1;0;3;2;0
18;19.1;20;10;14;6;0;12;18;66.7;6;22;15;7;27;47;72;1
19;29.2;84;51;43;31;10;45;72;62.5;27;39;9;30;28;112;46;0
20;17.0;0;0;0;0;0;0;0;;0;0;0;0;1;1;8;1
21;2.0;0;0;0;0;0;0;0;;0;0;0;0;0;0;3;0
22;16.0;16;9;9;7;0;9;17;52.9;8;16;3;13;18;34;41;0
23;1.6;5;3;5;0;0;3;6;50.0;3;1;0;1;2;7;10;0
24;15.0;48;38;27;16;5;30;49;61.2;19;13;4;9;19;67;30;0
25;1.4;1;1;1;0;0;0;2;0.0;2;1;0;1;1;2;0;0
26;3.1;3;1;1;1;1;2;4;50.0;2;4;1;3;3;6;12;0
27;12.4;21;9;13;7;1;9;22;40.9;13;14;7;7;17;38;55;3
28;0.2;1;1;1;0;0;0;1;0.0;1;0;0;0;0;1;0;0
29;10.3;27;18;19;7;1;12;22;54.5;10;11;5;6;19;46;25;0
30;1.0;0;0;0;0;0;0;0;;0;0;0;0;0;0;1;0
31;7.9;14;11;6;8;0;6;14;42.9;8;9;3;6;6;20;8;0
32;26.8;58;36;22;33;3;25;56;44.6;31;28;4;24;19;77;18;0
33;5.2;7;3;3;4;0;3;5;60.0;2;3;2;1;8;15;16;0
34;5.3;13;9;5;4;4;9;11;81.8;2;11;3;8;6;19;14;0
35;31.4;65;33;35;24;6;31;57;54.4;26;33;11;22;47;112;43;0
36;3.1;3;2;1;1;1;1;4;25.0;3;4;1;3;1;4;3;0
37;3.7;3;2;1;2;0;1;6;16.7;5;2;0;2;0;3;2;0
38;12.5;20;14;6;12;2;9;23;39.1;14;4;0;4;8;28;3;0
39;23.6;46;27;22;18;6;22;46;47.8;24;13;6;7;16;62;56;0
40;25.0;0;0;0;0;0;0;0;;0;0;0;0;0;0;12;3
41;0.7;4;2;0;3;1;1;2;50.0;1;3;2;1;0;4;1;0
42;1.4;4;2;2;2;0;1;1;100.0;0;1;1;0;0;4;8;0
43;23.0;70;37;33;28;9;36;60;60.0;24;23;6;17;27;97;57;0
44;0.3;0;0;0;0;0;0;0;;0;0;0;0;0;0;0;0
45;1.7;3;1;2;1;0;2;3;66.7;1;1;1;0;1;4;1;0
46;2.3;;0;;;;;;;;;;;0;;;
47;5.6;10;7;1;5;4;6;18;33.3;12;8;0;8;7;17;2;0
48;0.5;2;2;1;1;0;2;3;66.7;1;0;0;0;0;2;0;0
49;12.9;22;11;12;8;2;9;20;45.0;11;21;7;14;19;41;39;0
50;17.0;0;0;0;0;0;0;1;0.0;1;0;0;0;0;0;6;0
51;8.0;0;0;0;0;0;0;0;;0;1;0;1;0;0;6;1
52;28.9;32;22;10;17;5;17;43;39.5;26;35;2;33;12;44;16;0
53;21.4;59;37;29;24;6;31;55;56.4;24;27;4;23;30;89;27;0
54;9.3;27;14;12;15;0;15;37;40.5;22;17;5;12;21;48;21;0
55;5.3;8;5;0;7;1;3;5;60.0;2;4;0;4;1;9;3;0
56;10.4;38;27;16;20;2;15;25;60.0;10;11;1;10;1;39;11;0
57;16.2;24;12;13;9;2;11;25;44.0;14;15;2;13;12;36;16;0
58;14.6;17;11;9;6;2;8;18;44.4;10;18;2;16;11;28;18;0
59;20.1;26;19;13;12;1;8;15;53.3;7;22;18;4;27;53;71;1
60;4.9;9;8;2;6;1;4;8;50.0;4;9;3;6;6;15;3;0
61;1.3;2;1;2;0;0;2;3;66.7;1;2;0;2;2;4;3;0
62;2.8;0;0;0;0;0;0;3;0.0;3;1;0;1;0;0;5;0
63;12.1;10;6;7;3;0;4;11;36.4;7;25;20;5;16;26;40;0
64;5.8;3;1;0;3;0;3;7;42.9;4;3;0;3;0;3;10;0
65;5.3;13;5;5;7;1;4;14;28.6;10;8;2;6;4;17;7;0
66;23.0;39;22;33;6;0;19;34;55.9;15;27;17;10;34;73;101;0
67;0.8;3;1;1;2;0;3;3;100.0;0;0;0;0;1;4;0;0
68;0.2;1;0;0;0;1;0;0;;0;0;0;0;0;1;0;0
69;1.8;3;3;1;2;0;2;3;66.7;1;3;2;1;4;7;4;0
70;7.9;5;3;0;4;1;4;8;50.0;4;3;0;3;1;6;4;0
71;11.3;13;7;7;6;0;2;11;18.2;9;13;4;9;11;24;11;0
72;24.7;68;35;39;27;2;30;60;50.0;30;23;10;13;19;87;29;1
73;22.3;38;25;31;7;0;19;27;70.4;8;29;21;8;38;76;105;2
74;0.1;0;0;0;0;0;0;0;;0;0;0;0;1;1;0;0
75;12.3;24;16;17;7;0;16;23;69.6;7;17;8;9;33;57;61;0
76;6.3;5;3;0;5;0;2;10;20.0;8;7;2;5;0;5;1;0
77;12.4;41;22;17;21;3;21;46;45.7;25;15;3;12;5;46;28;0
78;32.6;2;2;2;0;0;1;1;100.0;0;1;0;1;1;3;15;2
79;0.6;3;1;3;0;0;3;5;60.0;2;0;0;0;1;4;1;0
80;25.9;9;5;2;7;0;3;12;25.0;9;10;1;9;4;13;29;0
81;27.5;45;29;33;11;1;24;38;63.2;14;27;13;14;62;107;107;1
82;31.9;29;20;18;6;5;13;44;29.5;31;30;4;26;25;54;10;0
83;0.8;4;4;0;4;0;2;3;66.7;1;1;1;0;0;4;0;0
84;8.3;23;17;7;14;2;11;23;47.8;12;11;2;9;3;26;0;0
85;19.7;19;14;4;11;4;7;20;35.0;13;21;2;19;4;23;12;0
86;13.5;19;12;5;12;2;5;18;27.8;13;17;4;13;8;27;10;0
87;20.2;37;17;30;6;1;19;40;47.5;21;23;12;11;26;63;67;0
88;27.1;53;31;22;26;5;20;45;44.4;25;31;3;28;27;80;11;1
89;23.4;20;11;6;7;7;11;36;30.6;25;10;0;10;8;28;7;0
90;23.0;62;42;34;25;3;41;63;65.1;22;35;7;28;21;83;70;0
91;26.0;27;15;7;15;5;12;27;44.4;15;22;1;21;25;52;21;0
92;14.4;8;5;6;1;1;5;9;55.6;4;20;15;5;13;21;100;0
93;10.1;5;4;3;1;1;2;8;25.0;6;8;2;6;3;8;9;0
94;4.1;3;3;2;1;0;2;2;100.0;0;3;2;1;6;9;30;1
95;9.0;8;5;3;4;1;3;9;33.3;6;6;0;6;5;13;4;0
96;28.1;30;15;8;13;9;13;38;34.2;25;21;1;20;7;37;11;1
97;29.8;43;27;23;20;0;20;49;40.8;29;20;7;13;65;108;81;1
98;0.3;4;1;0;4;0;2;2;100.0;0;0;0;0;0;4;0;0
99;23.1;27;17;22;5;0;15;21;71.4;6;33;19;14;27;54;78;2
100;5.8;6;5;0;3;3;1;4;25.0;3;3;0;3;3;9;2;0
101;11.3;17;12;7;9;1;12;23;52.2;11;14;4;10;14;31;24;0
102;21.2;23;12;13;8;2;14;18;77.8;4;25;6;19;22;45;52;0
103;0.3;2;1;0;1;1;0;0;;0;2;0;2;0;2;0;0
104;0.7;1;1;0;1;0;0;0;;0;0;0;0;1;2;1;0
105;17.3;35;22;13;17;5;18;41;43.9;23;23;0;23;11;46;4;1
106;32.6;59;35;42;14;3;31;52;59.6;21;32;8;24;38;97;88;1
107;32.0;39;26;6;24;9;15;30;50.0;15;17;3;14;15;54;22;0
108;8.5;1;1;1;0;0;1;1;100.0;0;1;0;1;0;1;4;0
109;0.7;1;1;0;1;0;1;1;100.0;0;1;0;1;0;1;0;0
110;21.5;37;20;15;17;5;19;37;51.4;18;14;3;11;12;49;9;1
111;11.1;15;11;1;8;6;6;17;35.3;11;12;3;9;1;16;9;0
112;3.0;7;4;2;3;2;3;7;42.9;4;3;0;3;2;9;0;0
113;1.2;1;1;1;0;0;1;4;25.0;3;0;0;0;2;3;0;0
114;3.9;6;2;1;5;0;4;10;40.0;6;2;1;1;4;10;0;0
115;15.7;27;18;16;9;2;13;17;76.5;4;11;3;8;13;40;25;0
116;2.4;6;5;2;4;0;1;2;50.0;1;1;1;0;0;6;1;0
117;13.3;35;29;24;10;1;22;28;78.6;6;11;2;9;17;52;49;0
118;0.7;0;0;0;0;0;0;0;;0;1;0;1;3;3;0;0
119;8.0;10;6;2;4;4;4;7;57.1;3;3;2;1;1;11;13;0
120;4.8;13;8;12;1;0;5;8;62.5;3;2;2;0;10;23;18;0
121;3.3;3;1;3;0;0;2;3;66.7;1;5;4;1;1;4;14;0
122;24.2;33;17;13;20;0;9;34;26.5;25;34;14;20;41;74;27;1
123;3.5;6;4;5;1;0;2;2;100.0;0;4;2;2;7;13;12;0
124;2.1;1;1;1;0;0;1;3;33.3;2;3;0;3;1;2;13;0
125;11.3;11;6;2;8;1;1;10;10.0;9;14;3;11;10;21;10;0
126;2.3;3;2;3;0;0;1;4;25.0;3;5;1;4;1;4;4;0
127;31.1;53;31;26;22;5;15;47;31.9;32;39;10;29;57;110;46;2
128;31.2;102;56;62;36;4;56;87;64.4;31;27;8;19;34;136;92;0
129;29.4;58;34;40;15;3;30;44;68.2;14;33;16;17;27;85;99;1
130;9.6;5;4;2;1;2;2;6;33.3;4;0;0;0;2;7;7;0
131;11.6;7;6;2;4;1;1;12;8.3;11;12;0;12;3;10;5;0
132;21.5;48;29;27;19;2;27;45;60.0;18;25;10;15;42;90;55;0
133;7.8;17;10;8;7;2;10;15;66.7;5;10;3;7;17;34;10;0
134;23.0;1;0;1;0;0;1;2;50.0;1;1;0;1;0;1;5;3
135;3.0;5;4;4;1;0;2;2;100.0;0;6;4;2;3;8;7;0
136;1.6;6;5;1;4;1;3;7;42.9;4;2;1;1;2;8;3;0
137;13.5;32;18;8;22;2;14;32;43.8;18;6;0;6;12;44;8;0
138;4.2;11;10;5;5;1;3;9;33.3;6;4;0;4;4;15;0;0
139;34.0;3;1;3;0;0;3;6;50.0;3;2;0;2;0;3;15;0
140;14.5;11;6;6;5;0;5;11;45.5;6;13;4;9;11;22;41;0
141;1.0;1;0;0;1;0;1;2;50.0;1;1;1;0;1;2;0;0
142;13.9;30;20;12;17;1;18;40;45.0;22;15;4;11;20;50;29;0
143;4.0;9;6;6;2;1;3;8;37.5;5;3;1;2;3;12;3;0
144;0.2;0;0;0;0;0;0;0;;0;0;0;0;0;0;2;0
145;23.4;19;10;4;10;5;7;12;58.3;5;19;2;17;5;24;13;0
146;33.5;62;39;40;18;4;25;52;48.1;27;48;33;15;28;90;131;1
147;0.2;0;0;0;0;0;0;0;;0;0;0;0;0;0;0;0
148;0.0;1;1;0;1;0;0;0;;0;0;0;0;0;1;0;0
149;22.0;22;13;1;13;8;10;29;34.5;19;24;5;19;8;30;2;0
150;0.5;0;0;0;0;0;0;0;;0;0;0;0;0;0;0;0
151;8.2;2;1;1;0;1;0;3;0.0;3;6;2;4;5;7;12;0
152;28.3;19;10;1;5;13;11;26;42.3;15;25;4;21;7;26;24;1
153;29.4;85;50;49;34;2;35;57;61.4;22;47;13;34;70;155;118;1
154;15.7;62;37;32;24;6;30;52;57.7;22;14;4;10;26;88;32;0
155;18.9;41;23;17;22;2;20;44;45.5;24;20;4;16;11;52;17;1
156;3.0;6;3;2;4;0;2;6;33.3;4;3;1;2;2;8;2;0
157;0.7;2;1;0;1;1;1;1;100.0;0;0;0;0;1;3;0;0
158;4.3;4;2;0;3;1;1;2;50.0;1;4;0;4;2;6;2;0
159;27.4;52;37;27;25;0;24;36;66.7;12;22;13;9;30;82;88;0
160;2.2;5;1;1;3;1;2;6;33.3;4;2;0;2;0;5;2;0
161;14.1;29;18;17;11;1;11;15;73.3;4;24;14;10;31;60;82;0
162;7.0;40;25;10;25;5;18;28;64.3;10;15;5;10;10;50;3;0
163;24.2;76;41;28;44;4;29;60;48.3;31;45;14;31;59;135;47;1
164;25.7;27;17;7;16;4;16;37;43.2;21;16;6;10;12;39;17;0
165;12.5;12;9;0;8;4;3;20;15.0;17;6;0;6;1;13;3;0
166;3.0;12;5;8;1;3;6;8;75.0;2;3;1;2;6;18;5;0
167;1.2;7;5;6;1;0;2;2;100.0;0;0;0;0;0;7;2;0
168;10.5;19;9;13;6;0;12;31;38.7;19;13;4;9;13;32;16;0
169;7.2;25;13;13;8;4;9;24;37.5;15;11;4;7;10;35;18;0
170;4.0;4;4;1;3;0;1;3;33.3;2;2;0;2;1;5;2;0
171;23.3;82;48;31;30;21;31;65;47.7;34;30;1;29;12;94;4;0
172;19.2;40;26;19;16;5;14;36;38.9;22;20;3;17;19;59;25;0
173;23.1;29;13;13;14;2;14;46;30.4;32;28;6;22;30;59;45;0
174;26.2;43;17;31;10;2;20;34;58.8;14;27;16;11;50;93;88;0
175;4.6;5;5;2;3;0;2;7;28.6;5;0;0;0;6;11;9;0
176;1.6;1;0;0;1;0;1;1;100.0;0;0;0;0;0;1;2;0
177;9.3;8;5;1;6;1;2;6;33.3;4;6;0;6;1;9;11;0
178;8.4;10;5;4;6;0;6;15;40.0;9;12;2;10;8;18;1;0
179;0.8;8;2;6;2;0;6;8;75.0;2;2;0;2;0;8;5;0
180;1.5;;3;;;;;;;;;;;1;;;
181;17.7;13;10;7;5;1;7;17;41.2;10;8;0;8;8;21;4;0
182;28.1;12;7;2;2;8;8;10;80.0;2;13;4;9;4;16;16;0
183;20.6;18;10;6;9;3;5;18;27.8;13;10;1;9;8;26;0;0
184;15.6;46;30;28;15;3;28;42;66.7;14;32;16;16;22;68;48;0
185;19.6;35;15;20;13;2;16;30;53.3;14;16;3;13;20;55;42;0
186;13.8;11;8;8;3;0;8;9;88.9;1;17;14;3;11;22;55;0
187;0.8;1;1;1;0;0;1;1;100.0;0;1;1;0;2;3;0;0
188;26.5;42;25;19;20;3;17;48;35.4;31;30;6;24;26;68;37;0
189;29.5;74;46;22;47;5;39;88;44.3;49;38;6;32;28;102;17;2
190;3.6;3;1;1;0;2;2;8;25.0;6;1;0;1;2;5;0;0
191;1.0;3;1;2;0;1;2;2;100.0;0;1;0;1;2;5;0;0
192;1.5;3;2;2;0;1;1;1;100.0;0;3;0;3;0;3;6;0
193;9.1;23;12;6;10;7;9;14;64.3;5;12;2;10;7;30;9;0
194;11.9;10;5;8;2;0;8;14;57.1;6;16;11;5;21;31;55;0
195;33.5;57;32;40;17;0;28;41;68.3;13;39;28;11;60;117;170;1
196;31.8;54;28;43;10;1;34;48;70.8;14;46;26;20;63;117;132;0
197;11.6;22;15;16;6;0;10;14;71.4;4;23;13;10;23;45;35;0
198;12.7;13;9;7;5;1;6;15;40.0;9;7;0;7;6;19;4;0
199;22.4;24;16;16;8;0;14;25;56.0;11;35;22;13;31;55;94;2
200;19.8;8;2;0;5;3;1;7;14.3;6;8;2;6;5;13;23;0
201;20.8;3;1;0;1;2;2;11;18.2;9;12;3;9;5;8;23;0
202;0.1;0;0;0;0;0;0;0;;0;0;0;0;0;0;1;0
203;10.8;29;18;17;12;0;18;29;62.1;11;15;7;8;13;42;35;0
204;24.8;61;38;30;25;6;26;53;49.1;27;21;2;19;37;98;58;0
205;0.2;1;0;0;1;0;0;0;;0;0;0;0;0;1;0;0
206;0.2;0;0;0;0;0;0;0;;0;0;0;0;0;0;0;0
207;14.8;28;12;19;8;1;16;29;55.2;13;20;6;14;18;46;23;0
208;17.0;26;18;18;6;2;17;22;77.3;5;21;7;14;29;55;43;0
209;10.5;24;14;11;10;3;15;28;53.6;13;14;3;11;16;40;14;0
210;0.2;1;1;0;1;0;0;0;;0;1;0;1;1;2;0;0
211;0.1;0;0;0;0;0;0;0;;0;0;0;0;0;0;0;0
212;0.2;0;0;0;0;0;0;0;;0;0;0;0;1;1;0;0
213;0.2;1;0;1;0;0;1;2;50.0;1;0;0;0;0;1;1;0
214;11.0;17;10;13;4;0;6;12;50.0;6;11;9;2;15;32;50;0
215;0.3;0;0;0;0;0;0;0;;0;1;0;1;0;0;1;0
216;8.3;;6;;;;;;;;;;;7;;;
217;4.6;7;2;3;3;1;3;12;25.0;9;5;1;4;3;10;2;0
218;9.1;24;18;8;14;2;11;18;61.1;7;11;2;9;7;31;2;0
219;12.0;26;15;17;7;2;14;24;58.3;10;9;2;7;13;39;47;0
220;23.4;50;24;25;19;6;30;80;37.5;50;26;1;25;22;72;19;0
221;13.6;42;25;20;18;4;24;45;53.3;21;16;2;14;23;65;32;0
222;29.0;1;1;0;0;1;1;4;25.0;3;10;2;8;4;5;21;0
223;16.6;18;9;3;11;4;6;20;30.0;14;28;2;26;3;21;21;0
224;4.5;1;0;0;1;0;1;1;100.0;0;5;0;5;0;1;5;0
225;12.6;16;10;6;10;0;6;13;46.2;7;19;13;6;20;36;59;0
226;4.0;7;6;3;4;0;5;7;71.4;2;2;0;2;2;9;15;1
227;4.0;10;5;5;5;0;3;7;42.9;4;5;1;4;6;16;5;0
228;0.0;0;0;0;0;0;0;0;;0;0;0;0;1;1;0;0
229;8.8;21;12;11;9;1;9;15;60.0;6;16;1;15;4;25;15;0
230;25.3;59;36;21;31;7;24;50;48.0;26;45;4;41;24;83;18;0
231;2.0;7;3;2;4;1;3;6;50.0;3;7;1;6;5;12;0;0
232;7.2;15;6;9;5;1;11;17;64.7;6;10;3;7;22;37;21;0
233;16.0;0;0;0;0;0;0;1;0.0;1;0;0;0;0;0;8;1
234;24.0;20;6;3;11;6;4;13;30.8;9;11;1;10;10;30;23;0
235;0.1;1;1;0;1;0;0;0;;0;0;0;0;0;1;0;0
236;15.1;23;12;2;15;6;7;28;25.0;21;15;2;13;5;28;17;0
237;5.5;2;2;0;1;1;2;5;40.0;3;6;1;5;3;5;3;0
238;1.0;4;2;1;3;0;3;3;100.0;0;0;0;0;0;4;0;0
239;4.7;7;5;3;4;0;4;8;50.0;4;4;1;3;6;13;4;0
240;15.3;29;22;11;14;4;9;24;37.5;15;18;4;14;17;46;18;0
241;12.2;16;6;3;9;4;5;15;33.3;10;16;1;15;5;21;6;0
242;25.5;44;29;25;17;2;25;45;55.6;20;28;12;16;29;73;75;0
243;3.6;8;5;3;5;0;5;9;55.6;4;4;1;3;6;14;2;0
244;0.6;2;2;2;0;0;1;1;100.0;0;1;0;1;1;3;2;0
245;27.0;41;20;19;19;3;23;52;44.2;29;35;13;22;30;71;60;1
246;9.3;12;8;9;3;0;7;10;70.0;3;12;8;4;21;33;22;0
247;17.4;40;31;29;10;1;19;30;63.3;11;25;15;10;16;56;83;0
248;3.5;5;3;4;1;0;3;6;50.0;3;2;0;2;3;8;5;0
249;3.4;6;5;1;5;0;4;11;36.4;7;10;0;10;3;9;2;1
250;6.5;12;8;6;6;0;5;8;62.5;3;5;3;2;8;20;7;0
251;2.0;0;0;0;0;0;0;0;;0;0;0;0;0;0;2;0
252;12.5;0;0;0;0;0;0;4;0.0;4;0;0;0;2;2;9;2
253;4.8;9;6;3;5;1;5;8;62.5;3;6;0;6;5;14;17;0
254;4.3;13;9;6;7;0;7;17;41.2;10;3;1;2;6;19;8;0
255;32.5;2;2;2;0;0;1;1;100.0;0;0;0;0;0;2;10;1
256;9.5;13;5;2;10;1;5;13;38.5;8;9;0;9;4;17;0;0
257;15.5;21;12;17;4;0;11;13;84.6;2;21;12;9;22;43;49;0
258;13.2;13;7;4;9;0;7;36;19.4;29;23;5;18;7;20;18;0
259;13.7;19;12;16;3;0;10;14;71.4;4;10;6;4;18;37;64;1
260;14.1;8;3;1;3;4;5;8;62.5;3;7;0;7;2;10;19;0
261;0.1;1;0;1;0;0;1;1;100.0;0;1;0;1;0;1;0;0
262;7.7;9;4;4;3;2;8;14;57.1;6;3;0;3;5;14;4;0
263;0.5;0;0;0;0;0;0;0;;0;0;0;0;0;0;0;0
264;7.1;2;2;0;2;0;1;3;33.3;2;2;0;2;1;3;7;0
265;12.4;23;14;10;8;5;10;24;41.7;14;24;2;22;9;32;1;0
266;1.5;3;0;2;1;0;1;3;33.3;2;3;0;3;2;5;0;0
267;23.8;40;26;14;18;8;18;40;45.0;22;25;4;21;13;53;22;0
268;18.7;53;29;15;33;5;23;49;46.9;26;46;11;35;38;91;26;0
269;7.9;10;8;3;5;2;6;13;46.2;7;6;0;6;5;15;1;0
270;17.2;51;26;23;24;4;21;42;50.0;21;13;2;11;8;59;11;0
271;34.0;34;22;20;12;2;11;30;36.7;19;52;31;21;58;92;141;1
272;15.4;35;18;16;15;4;19;41;46.3;22;13;3;10;13;48;21;0
273;23.9;57;39;19;31;7;21;43;48.8;22;31;0;31;14;71;7;0
274;16.3;15;10;1;10;4;3;8;37.5;5;8;0;8;4;19;12;0
275;8.8;13;8;1;7;5;5;12;41.7;7;5;0;5;2;15;5;0
276;0.8;0;0;0;0;0;0;0;;0;0;0;0;0;0;0;0
277;6.5;8;7;3;4;1;4;11;36.4;7;5;0;5;4;12;5;0
278;5.6;10;6;3;6;1;4;7;57.1;3;8;0;8;1;11;2;0
279;30.9;14;7;3;8;3;5;14;35.7;9;6;3;3;1;15;21;0
280;2.0;8;5;4;4;0;2;13;15.4;11;4;1;3;2;10;3;0
281;9.8;16;10;5;11;0;8;15;53.3;7;10;2;8;5;21;13;1
282;25.6;41;25;6;31;4;15;44;34.1;29;19;3;16;12;53;27;1
283;27.8;24;9;18;6;0;16;43;37.2;27;36;27;9;47;71;124;0
284;29.2;66;39;41;21;4;33;53;62.3;20;33;5;28;37;103;47;0
285;22.5;49;25;31;15;3;19;44;43.2;25;23;9;14;27;76;47;1
286;10.0;;3;;;;;;;;;;;5;;;
287;6.6;;1;;;;;;;;;;;0;;;
288;21.1;36;19;14;21;1;11;40;27.5;29;31;9;22;33;69;46;0
289;0.5;5;5;3;1;1;2;3;66.7;1;1;0;1;1;6;2;0
290;2.4;0;0;0;0;0;0;3;0.0;3;0;0;0;0;0;3;0
291;0.5;2;0;1;1;0;0;3;0.0;3;1;1;0;0;2;1;0
292;3.0;4;4;4;0;0;4;5;80.0;1;7;2;5;6;10;8;0
293;11.0;0;0;0;0;0;0;0;;0;1;0;1;0;0;7;0
294;34.0;0;0;0;0;0;0;0;;0;0;0;0;0;0;18;2
295;28.9;99;61;42;48;9;49;78;62.8;29;39;20;19;59;158;67;0
296;5.2;9;5;5;4;0;3;8;37.5;5;6;2;4;5;14;10;0
297;20.0;0;0;0;0;0;0;1;0.0;1;0;0;0;0;0;8;3
298;10.1;30;16;14;12;4;12;29;41.4;17;10;2;8;16;46;13;0
299;1.1;0;0;0;0;0;0;3;0.0;3;1;0;1;0;0;0;0
300;18.2;37;19;15;19;3;14;29;48.3;15;11;4;7;32;69;14;0
301;8.0;8;5;7;1;0;5;6;83.3;1;7;6;1;8;16;32;0
302;8.4;24;15;9;8;7;15;27;55.6;12;13;0;13;4;28;4;1
303;11.0;0;0;0;0;0;0;0;;0;0;0;0;0;0;7;1
304;7.2;7;4;1;4;2;4;16;25.0;12;6;0;6;3;10;3;0
305;8.2;20;13;7;12;1;13;19;68.4;6;13;1;12;11;31;12;0
306;17.1;9;5;0;6;3;2;7;28.6;5;7;0;7;2;11;7;0
307;4.8;11;9;3;4;4;4;8;50.0;4;7;0;7;5;16;1;0
308;7.5;14;8;8;6;0;9;13;69.2;4;11;2;9;5;19;5;0
309;1.0;0;0;0;0;0;0;0;;0;0;0;0;0;0;0;0
310;20.8;40;23;24;14;2;21;35;60.0;14;31;15;16;33;73;60;0
311;0.1;0;0;0;0;0;0;0;;0;0;0;0;0;0;0;0
312;16.5;19;9;12;6;1;14;21;66.7;7;7;2;5;8;27;27;0
313;29.5;97;50;41;50;6;45;90;50.0;45;46;11;35;64;161;70;0
314;4.8;3;1;0;1;2;1;3;33.3;2;3;0;3;0;3;4;0
315;24.7;34;22;13;20;1;10;20;50.0;10;37;21;16;43;77;73;0
316;28.3;46;23;29;16;1;20;41;48.8;21;20;2;18;29;75;30;2
317;0.0;0;0;0;0;0;0;0;;0;1;1;0;0;0;0;0
318;14.0;38;21;14;18;6;20;42;47.6;22;14;2;12;31;69;42;0
319;0.3;1;0;0;0;1;1;1;100.0;0;1;0;1;0;1;0;0
320;10.7;19;14;11;7;1;9;20;45.0;11;9;4;5;11;30;16;0
321;6.3;13;9;12;0;1;12;19;63.2;7;3;0;3;2;15;14;0
322;5.9;11;7;4;5;2;5;18;27.8;13;7;1;6;8;19;5;0
323;9.4;22;17;6;13;3;9;19;47.4;10;11;0;11;9;31;2;0
324;24.7;49;31;28;19;2;23;40;57.5;17;30;9;21;44;93;136;1
325;7.2;6;5;0;5;1;2;8;25.0;6;5;0;5;4;10;4;0
326;15.6;22;14;12;10;0;10;31;32.3;21;15;3;12;11;33;11;0
327;6.8;18;11;7;9;2;8;13;61.5;5;5;1;4;3;21;14;0
328;6.3;1;0;0;1;0;1;5;20.0;4;3;1;2;2;3;1;0
329;1.2;1;0;0;1;0;1;2;50.0;1;0;0;0;0;1;0;0
330;11.8;29;21;11;14;4;14;34;41.2;20;13;0;13;7;36;3;0
331;0.2;0;0;0;0;0;0;0;;0;0;0;0;0;0;0;0
332;2.8;6;2;3;2;1;3;5;60.0;2;1;0;1;3;9;6;0
333;16.4;27;17;22;5;0;17;27;63.0;10;27;19;8;17;44;80;0
334;9.1;28;16;12;15;1;18;35;51.4;17;18;3;15;8;36;3;0
335;5.7;8;4;3;5;0;4;6;66.7;2;5;0;5;5;13;2;0
336;24.0;43;21;24;15;4;21;68;30.9;47;20;5;15;17;60;25;0
337;4.9;10;6;5;3;2;6;12;50.0;6;3;2;1;14;24;10;0
338;7.0;0;0;0;0;0;0;0;;0;0;0;0;0;0;1;0
339;17.0;1;0;1;0;0;1;1;100.0;0;0;0;0;0;1;9;0
340;0.1;0;0;0;0;0;0;1;0.0;1;2;1;1;0;0;0;0
341;32.0;62;35;23;29;10;31;89;34.8;58;26;3;23;27;89;25;0
342;1.1;0;0;0;0;0;0;1;0.0;1;0;0;0;0;0;2;0
343;4.7;12;6;5;6;1;5;8;62.5;3;4;1;3;12;24;27;1
344;20.9;20;11;2;8;10;5;19;26.3;14;16;0;16;6;26;15;0
345;0.5;5;1;3;1;1;3;5;60.0;2;2;0;2;0;5;0;0
346;6.1;14;8;1;9;4;7;13;53.8;6;8;3;5;12;26;7;0
347;18.2;40;25;18;15;7;25;46;54.3;21;22;6;16;31;71;15;1
348;28.3;15;12;1;6;8;4;13;30.8;9;19;3;16;9;24;10;0
349;8.7;28;16;11;15;2;16;23;69.6;7;10;1;9;8;36;7;0
350;6.4;3;1;1;2;0;0;4;0.0;4;5;4;1;0;3;13;0
351;4.8;12;10;8;3;1;7;8;87.5;1;3;2;1;11;23;15;0
352;6.2;18;10;15;3;0;11;15;73.3;4;3;1;2;10;28;24;1
353;5.5;8;6;1;4;3;4;8;50.0;4;3;0;3;3;11;1;0
354;11.7;29;14;20;8;1;18;28;64.3;10;14;9;5;8;37;24;0
355;6.0;22;11;10;7;5;9;18;50.0;9;8;1;7;6;28;9;0
356;0.1;0;0;0;0;0;0;0;;0;0;0;0;0;0;0;0
357;1.3;1;1;1;0;0;0;1;0.0;1;1;1;0;1;2;2;0
358;4.4;4;4;0;3;1;1;5;20.0;4;4;1;3;3;7;2;0
359;1.1;0;0;0;0;0;0;0;;0;1;0;1;0;0;0;0
360;0.1;0;0;0;0;0;0;0;;0;0;0;0;0;0;0;0
361;4.8;11;4;3;7;1;7;12;58.3;5;2;1;1;2;13;17;0
362;3.9;8;5;6;2;0;3;9;33.3;6;7;2;5;7;15;8;0
363;20.6;35;22;19;16;0;15;34;44.1;19;23;1;22;22;57;8;1
364;10.7;22;12;8;10;4;17;32;53.1;15;12;2;10;8;30;12;0
365;27.9;46;25;35;10;1;36;44;81.8;8;20;5;15;32;78;81;2
366;18.8;19;18;10;6;3;8;24;33.3;16;15;1;14;17;36;6;0
367;18.0;18;13;6;7;5;6;16;37.5;10;13;3;10;6;24;12;0
368;29.7;51;33;19;21;11;18;53;34.0;35;31;2;29;14;65;9;0
369;25.7;32;19;14;15;3;17;43;39.5;26;25;8;17;32;64;48;1
370;4.5;6;6;5;1;0;5;5;100.0;0;1;1;0;9;15;20;1
371;3.5;3;1;0;2;1;0;4;0.0;4;1;0;1;0;3;3;0
372;23.5;48;26;17;26;5;26;49;53.1;23;22;1;21;16;64;25;0
373;3.8;3;2;2;1;0;2;4;50.0;2;2;1;1;2;5;16;0
374;9.8;22;9;4;17;1;13;21;61.9;8;11;6;5;15;37;23;1
375;9.4;3;1;0;2;1;0;3;0.0;3;5;0;5;0;3;8;0
376;9.2;22;11;5;10;7;9;24;37.5;15;12;4;8;5;27;6;0
377;9.7;25;19;15;7;3;12;20;60.0;8;13;4;9;9;34;18;0
378;12.9;28;16;5;20;3;12;29;41.4;17;13;2;11;10;38;12;0
379;15.5;21;13;9;10;2;10;26;38.5;16;8;0;8;7;28;4;0
380;8.6;7;5;5;2;0;4;5;80.0;1;3;2;1;4;11;45;0
381;9.7;21;12;6;13;2;11;32;34.4;21;7;0;7;6;27;1;0
382;3.0;10;6;6;4;0;3;7;42.9;4;6;3;3;10;20;8;0
383;5.1;4;3;0;4;0;2;7;28.6;5;2;0;2;0;4;1;0
384;3.5;0;0;0;0;0;0;0;;0;0;0;0;0;0;0;0
385;20.8;21;13;11;10;0;13;21;61.9;8;22;19;3;19;40;74;0
386;0.6;1;1;1;0;0;1;2;50.0;1;1;0;1;0;1;0;0
387;8.6;20;7;15;5;0;14;27;51.9;13;6;0;6;2;22;4;0
388;14.4;43;26;26;14;3;30;48;62.5;18;19;1;18;10;53;31;0
389;2.4;9;7;2;6;1;5;7;71.4;2;3;1;2;0;9;2;0
390;19.0;48;27;25;17;6;19;41;46.3;22;20;2;18;26;74;15;2
391;31.0;44;23;25;15;4;23;38;60.5;15;23;11;12;20;64;132;3
392;22.1;82;59;39;40;3;48;83;57.8;35;28;4;24;16;98;43;0
393;1.3;1;1;0;1;0;0;1;0.0;1;4;0;4;1;2;0;0
394;0.5;1;1;0;1;0;1;1;100.0;0;0;0;0;0;1;2;0
395;0.1;1;0;0;1;0;0;0;;0;0;0;0;0;1;0;0
396;25.6;;18;;;;;;;;;;;10;;;
397;13.3;17;13;13;4;0;4;6;66.7;2;10;6;4;30;47;57;0
398;10.3;7;5;0;5;2;3;5;60.0;2;9;3;6;2;9;10;0
399;4.8;2;1;0;1;1;2;5;40.0;3;2;2;0;0;2;9;0
400;0.0;0;0;0;0;0;0;0;;0;0;0;0;0;0;0;0
401;20.3;32;20;17;13;2;15;43;34.9;28;13;3;10;16;48;13;0
402;30.4;18;7;15;3;0;11;25;44.0;14;50;41;9;46;64;129;1
403;10.5;36;19;25;8;3;21;43;48.8;22;14;2;12;17;53;27;1
404;6.6;4;2;0;1;3;1;5;20.0;4;2;1;1;1;5;4;0
405;0.4;0;0;0;0;0;0;0;;0;0;0;0;0;0;0;0
406;16.0;0;0;0;0;0;0;0;;0;0;0;0;0;0;2;0
407;14.2;19;10;15;4;0;5;6;83.3;1;17;8;9;20;39;50;1
408;31.5;58;41;27;27;4;36;60;60.0;24;36;12;24;32;90;66;0
409;32.3;47;31;31;15;1;29;42;69.0;13;29;11;18;39;86;78;0
410;0.3;0;0;0;0;0;0;1;0.0;1;0;0;0;0;0;0;0
411;0.3;2;0;0;2;0;0;0;;0;0;0;0;0;2;0;0
412;0.6;0;0;0;0;0;0;0;;0;0;0;0;0;0;1;0
413;4.3;1;1;0;0;1;0;1;0.0;1;5;0;5;1;2;4;0
414;12.2;13;7;5;6;2;7;15;46.7;8;19;11;8;17;30;37;0
415;17.0;0;0;0;0;0;0;0;;0;0;0;0;1;1;7;3
416;13.6;22;10;11;7;4;9;19;47.4;10;16;3;13;15;37;26;0
417;3.7;6;2;2;4;0;1;1;100.0;0;2;0;2;5;11;7;0
418;4.8;14;9;6;6;2;8;17;47.1;9;11;5;6;8;22;12;1
419;6.4;5;2;3;2;0;1;6;16.7;5;6;5;1;8;13;21;2
420;1.0;0;0;0;0;0;0;0;;0;0;0;0;0;0;0;0
421;21.4;53;27;32;19;2;28;48;58.3;20;22;10;12;31;84;64;0
422;24.7;64;39;33;28;3;27;69;39.1;42;28;5;23;54;118;18;0
423;2.1;3;2;1;2;0;1;4;25.0;3;1;0;1;1;4;2;0
424;5.4;6;5;4;2;0;1;6;16.7;5;2;0;2;10;16;15;1
425;24.2;19;8;9;10;0;6;14;42.9;8;27;17;10;28;47;86;0
426;11.6;15;7;5;8;2;6;18;33.3;12;11;3;8;6;21;8;0
427;6.3;7;5;2;2;3;3;4;75.0;1;7;1;6;0;7;2;0
428;2.5;7;5;6;1;0;5;8;62.5;3;3;2;1;6;13;5;0
429;6.5;19;11;3;13;3;7;22;31.8;15;5;1;4;4;23;2;0
430;0.9;5;2;3;2;0;3;7;42.9;4;2;1;1;3;8;2;0
431;0.2;0;0;0;0;0;0;0;;0;0;0;0;1;1;0;0
432;0.2;1;1;0;1;0;1;1;100.0;0;0;0;0;0;1;0;0
433;2.5;4;2;2;1;1;2;4;50.0;2;2;0;2;1;5;0;0
434;0.2;0;0;0;0;0;0;0;;0;0;0;0;0;0;2;0
435;8.8;18;7;7;9;2;7;18;38.9;11;12;1;11;4;22;6;0
436;0.2;1;0;0;0;1;0;0;;0;1;1;0;1;2;1;0
437;3.0;;9;;;;;;;;;;;5;;;
438;10.1;30;17;21;7;2;16;29;55.2;13;12;4;8;11;41;16;0
439;8.5;9;5;6;3;0;6;6;100.0;0;8;4;4;10;19;42;0
440;30.9;55;24;22;31;2;28;63;44.4;35;43;8;35;23;78;47;0
441;8.8;15;7;5;9;1;8;11;72.7;3;10;1;9;4;19;0;0
442;1.3;3;2;1;1;1;3;6;50.0;3;2;0;2;1;4;5;0
443;8.5;28;12;11;15;2;10;24;41.7;14;21;4;17;11;39;13;0
444;27.5;81;48;45;31;5;40;68;58.8;28;44;11;33;47;128;62;0
445;28.6;19;13;2;9;8;4;14;28.6;10;17;3;14;1;20;22;0
446;0.2;1;0;0;0;1;0;0;;0;0;0;0;0;1;0;0
447;8.0;14;8;10;4;0;7;8;87.5;1;18;14;4;18;32;40;0
448;31.6;15;10;2;7;6;7;22;31.8;15;14;3;11;6;21;1;0
449;1.7;2;2;2;0;0;2;4;50.0;2;2;0;2;0;2;0;0
450;0.7;1;1;0;1;0;1;1;100.0;0;0;0;0;4;5;2;0
451;0.9;0;0;0;0;0;0;0;;0;2;0;2;0;0;1;0
452;1.0;0;0;0;0;0;0;0;;0;0;0;0;0;0;1;0
453;15.6;16;12;8;7;1;7;17;41.2;10;16;5;11;8;24;21;0
454;21.8;34;23;18;16;0;11;24;45.8;13;29;19;10;40;74;81;0
455;14.0;32;19;12;20;0;26;38;68.4;12;19;14;5;35;67;52;0
456;16.3;32;17;16;15;1;16;29;55.2;13;23;9;14;43;75;38;0
457;0.6;3;3;1;2;0;2;2;100.0;0;1;0;1;0;3;0;0
458;0.4;0;0;0;0;0;0;0;;0;0;0;0;0;0;0;0
459;26.7;72;41;41;25;6;36;52;69.2;16;24;5;19;40;112;50;0
460;0.3;1;0;0;1;0;1;2;50.0;1;1;0;1;0;1;2;1
461;6.2;10;9;1;7;2;1;4;25.0;3;5;2;3;4;14;10;0
462;4.8;21;12;10;10;1;8;21;38.1;13;7;2;5;4;25;4;0
463;13.0;53;21;18;31;4;14;47;29.8;33;21;8;13;21;74;12;0
464;29.6;65;38;38;24;3;42;83;50.6;41;28;6;22;33;98;46;0
465;0.5;0;0;0;0;0;0;1;0.0;1;2;0;2;1;1;1;0
466;6.3;10;4;3;6;1;4;9;44.4;5;5;0;5;4;14;3;0
467;0.2;1;1;1;0;0;0;0;;0;0;0;0;0;1;1;0
468;19.8;36;22;15;18;3;18;44;40.9;26;18;6;12;27;63;11;1
469;1.9;7;1;3;3;1;3;6;50.0;3;3;1;2;2;9;1;0
470;7.9;7;4;1;4;2;4;15;26.7;11;4;1;3;3;10;1;0
471;28.2;23;12;6;14;3;10;31;32.3;21;29;7;22;20;43;10;1
472;2.2;2;1;0;1;1;0;3;0.0;3;4;0;4;4;6;0;0
473;0.1;0;0;0;0;0;0;0;;0;0;0;0;0;0;0;0
474;6.1;10;7;4;4;2;8;13;61.5;5;10;1;9;6;16;6;0
475;3.0;0;0;0;0;0;0;0;;0;0;0;0;0;0;2;0
476;25.6;38;25;15;18;5;16;35;45.7;19;21;3;18;7;45;13;0
477;3.2;10;2;5;5;0;4;8;50.0;4;3;0;3;7;17;17;0
478;0.5;3;3;3;0;0;1;2;50.0;1;1;0;1;0;3;0;0
479;21.2;51;31;10;28;13;18;34;52.9;16;22;1;21;18;69;11;0
480;0.0;0;0;0;0;0;0;0;;0;0;0;0;0;0;1;0
481;18.2;31;17;27;4;0;15;28;53.6;13;9;4;5;16;47;30;0
482;0.9;1;0;0;1;0;0;0;;0;2;0;2;1;2;0;0
483;3.5;3;2;2;0;1;1;2;50.0;1;0;0;0;1;4;0;0
484;8.5;19;10;7;11;1;7;25;28.0;18;10;0;10;5;24;7;1
485;8.0;12;7;5;7;0;4;10;40.0;6;5;0;5;3;15;4;0
486;12.0;35;21;16;18;1;15;48;31.3;33;8;1;7;8;43;7;1
487;29.6;56;32;25;24;7;19;68;27.9;49;31;6;25;34;90;38;0
488;21.8;58;36;26;27;5;34;69;49.3;35;50;4;46;22;80;36;0
489;18.1;48;32;15;30;3;18;47;38.3;29;16;2;14;29;77;36;0
490;7.6;5;2;0;5;0;3;12;25.0;9;4;1;3;1;6;11;0
491;4.3;6;3;3;2;1;2;10;20.0;8;5;2;3;0;6;6;0
492;1.9;1;1;1;0;0;1;1;100.0;0;2;1;1;4;5;12;0
493;0.8;2;2;0;2;0;0;0;;0;0;0;0;0;2;4;0
494;27.2;76;42;30;43;3;21;36;58.3;15;47;12;35;26;102;31;0
495;8.3;12;9;2;4;6;6;17;35.3;11;4;0;4;2;14;5;0
496;22.5;23;14;9;13;1;12;31;38.7;19;16;8;8;16;39;29;0
497;29.9;26;17;19;5;2;19;25;76.0;6;32;18;14;57;83;100;1
498;24.2;26;12;7;15;4;16;41;39.0;25;14;0;14;13;39;7;0
499;2.6;3;2;3;0;0;0;2;0.0;2;2;0;2;3;6;0;0
500;25.6;67;40;33;26;8;37;76;48.7;39;33;6;27;31;98;44;0
501;1.0;0;0;0;0;0;0;1;0.0;1;0;0;0;0;0;2;1
502;31.8;76;46;29;37;10;37;98;37.8;61;31;4;27;40;116;21;0
503;7.2;21;10;14;5;2;11;18;61.1;7;6;1;5;11;32;15;0
504;5.5;4;2;2;2;0;3;6;50.0;3;8;4;4;7;11;23;0
505;1.7;8;5;3;5;0;3;3;100.0;0;2;2;0;1;9;8;0
506;24.1;48;25;19;24;5;22;73;30.1;51;19;2;17;29;77;15;0
507;0.0;0;0;0;0;0;0;0;;0;0;0;0;0;0;0;0
508;9.5;13;6;6;5;2;8;17;47.1;9;8;2;6;14;27;28;0
509;8.8;8;6;3;2;3;2;5;40.0;3;6;0;6;1;9;7;0
510;20.4;43;26;28;14;1;17;28;60.7;11;30;14;16;38;81;66;0
511;4.9;1;0;1;0;0;1;2;50.0;1;0;0;0;0;1;2;1
512;18.4;34;21;25;7;2;20;27;74.1;7;17;11;6;39;73;58;2
513;0.0;0;0;0;0;0;0;0;;0;0;0;0;0;0;0;0
514;10.1;7;6;0;3;4;0;4;0.0;4;5;2;3;1;8;6;0
515;3.3;7;2;4;3;0;1;1;100.0;0;2;0;2;0;7;4;0
516;20.2;37;20;11;18;8;10;36;27.8;26;16;4;12;14;51;4;0
517;22.8;7;6;2;5;0;1;11;9.1;10;13;4;9;5;12;18;0
518;32.4;26;19;18;8;0;18;26;69.2;8;32;23;9;48;74;113;0
519;11.1;16;9;6;7;3;4;17;23.5;13;7;1;6;4;20;5;0
520;13.7;27;13;16;10;1;14;27;51.9;13;17;0;17;16;43;8;1
521;8.3;13;9;8;3;2;4;8;50.0;4;7;2;5;9;22;4;0
522;31.0;0;0;0;0;0;0;0;;0;1;0;1;2;2;16;0
523;30.7;61;32;37;22;2;36;58;62.1;22;37;14;23;48;109;104;0
524;1.1;1;0;0;1;0;0;1;0.0;1;1;0;1;3;4;4;0
525;12.8;20;13;16;4;0;8;14;57.1;6;18;10;8;34;54;66;1
526;5.4;3;0;0;1;2;1;4;25.0;3;4;0;4;1;4;1;0
527;5.3;13;7;3;6;4;7;21;33.3;14;6;0;6;3;16;4;0
528;3.7;6;3;1;3;2;5;8;62.5;3;4;0;4;2;8;1;0
529;1.2;2;1;1;0;1;1;4;25.0;3;3;0;3;2;4;0;0
530;9.0;2;1;1;1;0;0;1;0.0;1;1;1;0;0;2;8;0
531;12.0;0;0;0;0;0;0;0;;0;0;0;0;0;0;0;1
532;0.4;1;1;0;1;0;0;0;;0;0;0;0;0;1;0;0
533;8.3;10;7;3;6;1;5;18;27.8;13;9;0;9;4;14;3;0
534;7.6;15;11;5;6;4;10;22;45.5;12;7;0;7;5;20;6;0
535;8.1;12;8;6;6;0;1;6;16.7;5;8;1;7;3;15;3;0
536;34.0;1;0;1;0;0;1;3;33.3;2;0;0;0;0;1;10;2
537;11.2;18;13;13;4;1;12;21;57.1;9;23;9;14;12;30;52;1
538;1.8;4;4;3;1;0;4;5;80.0;1;3;1;2;2;6;6;0
539;4.9;9;4;4;5;0;6;9;66.7;3;4;1;3;7;16;11;0
540;3.5;5;5;0;4;1;2;4;50.0;2;1;0;1;1;6;3;0
541;0.2;1;0;1;0;0;1;2;50.0;1;1;1;0;0;1;0;0
542;6.0;15;9;6;9;0;11;20;55.0;9;5;2;3;6;21;8;0
543;23.8;27;18;20;7;0;13;21;61.9;8;24;20;4;50;77;133;2
544;6.5;5;1;1;1;3;2;5;40.0;3;3;1;2;1;6;4;0
545;2.1;6;3;3;3;0;1;2;50.0;1;0;0;0;2;8;5;0
546;1.9;3;1;1;2;0;1;5;20.0;4;1;0;1;2;5;2;0
547;8.2;7;2;3;2;2;4;13;30.8;9;5;1;4;6;13;3;0
548;0.6;1;1;1;0;0;1;1;100.0;0;0;0;0;0;1;0;0
549;3.4;16;4;7;9;0;5;12;41.7;7;2;1;1;6;22;9;0
550;1.7;5;5;2;2;1;5;9;55.6;4;2;1;1;1;6;0;0
551;5.3;11;8;2;7;2;7;17;41.2;10;11;1;10;2;13;6;0
552;30.5;0;0;0;0;0;0;1;0.0;1;0;0;0;0;0;13;2
553;27.7;25;13;7;13;5;12;34;35.3;22;24;5;19;9;34;29;0
554;6.1;7;3;6;1;0;4;8;50.0;4;7;4;3;8;15;27;0
555;10.7;21;12;6;12;3;8;33;24.2;25;12;1;11;2;23;2;1
556;15.6;29;16;23;5;1;13;27;48.1;14;14;2;12;23;52;33;1
557;29.1;1;1;1;0;0;1;1;100.0;0;1;0;1;1;2;9;2
558;5.4;11;5;5;6;0;4;8;50.0;4;7;1;6;7;18;15;1
559;22.6;25;16;10;12;3;10;18;55.6;8;12;2;10;7;32;15;0
560;18.6;19;15;9;10;0;10;25;40.0;15;9;6;3;23;42;55;0
561;3.8;10;4;4;5;1;4;9;44.4;5;1;0;1;7;17;4;0
562;0.0;0;0;0;0;0;0;0;;0;0;0;0;0;0;0;0
563;8.4;23;17;17;4;2;9;15;60.0;6;9;6;3;17;40;33;0
564;5.2;14;5;7;6;1;5;10;50.0;5;9;4;5;9;23;11;1
565;1.8;1;1;0;1;0;0;1;0.0;1;1;0;1;4;5;2;0
566;0.8;3;2;1;2;0;1;1;100.0;0;0;0;0;0;3;0;0
567;2.2;2;1;1;1;0;0;3;0.0;3;4;0;4;2;4;1;0
568;25.4;39;21;27;12;0;12;28;42.9;16;42;32;10;66;105;110;2
569;21.5;0;0;0;0;0;0;1;0.0;1;0;0;0;1;1;11;2
570;4.6;17;7;14;3;0;9;21;42.9;12;5;1;4;5;22;9;0
571;0.9;1;1;0;0;1;1;1;100.0;0;1;1;0;0;1;2;0
572;11.1;16;9;7;7;2;10;28;35.7;18;7;0;7;2;18;2;0
573;7.7;10;5;2;7;1;3;12;25.0;9;2;0;2;5;15;4;0
574;0.2;0;0;0;0;0;0;0;;0;0;0;0;2;2;1;0
575;0.3;1;1;1;0;0;1;1;100.0;0;0;0;0;0;1;0;0
576;5.9;2;0;1;0;1;0;4;0.0;4;4;0;4;2;4;5;0
577;1.7;1;1;1;0;0;1;3;33.3;2;1;0;1;0;1;4;0
578;17.0;23;18;12;10;1;12;35;34.3;23;17;0;17;7;30;3;1
579;32.0;1;1;1;0;0;1;2;50.0;1;0;0;0;0;1;29;3
580;15.0;26;16;7;16;3;11;22;50.0;11;15;2;13;11;37;9;0
581;9.2;22;11;9;13;0;7;19;36.8;12;13;1;12;4;26;6;0
582;22.7;31;18;9;17;5;18;42;42.9;24;23;1;22;12;43;15;0
583;0.2;2;2;0;2;0;0;0;;0;0;0;0;0;2;1;0
584;7.8;12;8;7;4;1;9;18;50.0;9;8;2;6;3;15;5;0
585;8.5;9;7;0;2;7;3;8;37.5;5;6;2;4;0;9;4;0
586;18.3;29;18;9;20;0;9;36;25.0;27;16;6;10;20;49;20;0
587;0.0;1;0;0;1;0;1;2;50.0;1;0;0;0;0;1;0;0
588;20.7;35;26;12;19;4;11;33;33.3;22;30;1;29;20;55;9;0
589;10.9;3;3;0;1;2;0;3;0.0;3;3;1;2;1;4;9;0
